[
  {
    "level": 1,
    "matrix": [
      [2, 2, 2, 2, 2, 2, 2, 2, 2, 2, 2],
      [7, 7, 7, 7, 7, 7, 7, 7, 7, 7, 7],
      [8, 8, 8, 8, 8, 8, 8, 8, 8, 8, 8],
      [6, 6, 6, 6, 6, 6, 6, 6, 6, 6, 6],
      [5, 5, 5, 5, 5, 5, 5, 5, 5, 5, 5],
      [4, 4, 4, 4, 4, 4, 4, 4, 4, 4, 4]
    ]
  },
  {
    "level": 2,
    "matrix": [
      [0, 7, 9, 6, 5, 0, 7, 9, 6, 9, 0],
      [0, 7, 10, 8, 5, 0, 10, 5, 8, 6, 0],
      [0, 5, 8, 7, 6, 0, 9, 8, 8, 8, 0],
      [0, 6, 8, 5, 9, 0, 5, 6, 9, 8, 0],
      [0, 6, 7, 9, 10, 0, 9, 8, 10, 5, 0],
      [0, 5, 6, 8, 7, 0, 9, 8, 9, 6, 0],
      [0, 5, 6, 7, 9, 0, 10, 9, 6, 8, 0],
      [0, 7, 9, 6, 5, 0, 7, 9, 6, 9, 0],
      [0, 7, 10, 8, 5, 0, 10, 5, 8, 6, 0],
      [0, 5, 8, 7, 6, 0, 9, 8, 8, 8, 0],
      [0, 6, 8, 5, 9, 0, 5, 6, 9, 8, 0],
      [0, 6, 7, 9, 10, 0, 9, 8, 10, 5, 0],
      [0, 7, 6, 8, 7, 0, 9, 7, 9, 6, 0],
      [0, 2, 2, 2, 2, 0, 2, 2, 2, 2, 0]
    ]
  }
]