[
  {
    "level": 1,
    "matrix": [
      [2, 2, 2, 2, 2, 2, 2, 2, 2, 2, 2],
      [7, 7, 7, 7, 7, 7, 7, 7, 7, 7, 7],
      [8, 8, 8, 8, 8, 8, 8, 8, 8, 8, 8],
      [6, 6, 6, 6, 6, 6, 6, 6, 6, 6, 6],
      [5, 5, 5, 5, 5, 5, 5, 5, 5, 5, 5],
      [4, 4, 4, 4, 4, 4, 4, 4, 4, 4, 4]
    ]
  },
  {
    "level": 2,
    "matrix": [
      [0, 2, 6, 4, 5, 0, 6, 4, 8, 2, 0],
      [0, 8, 4, 6, 7, 0, 4, 6, 2, 8, 0],
      [0, 4, 6, 7, 6, 0, 8, 2, 8, 8, 0],
      [0, 6, 8, 5, 4, 0, 2, 8, 4, 8, 0],
      [0, 6, 7, 4, 2, 0, 6, 8, 7, 5, 0],
      [0, 5, 6, 2, 7, 0, 4, 8, 4, 6, 0],
      [0, 5, 2, 7, 4, 0, 7, 4, 6, 8, 0],
      [0, 2, 4, 6, 5, 0, 7, 4, 6, 4, 0],
      [0, 7, 7, 8, 5, 0, 7, 8, 7, 2, 0],
      [0, 5, 8, 7, 6, 0, 4, 5, 2, 8, 0],
      [0, 6, 8, 5, 4, 0, 4, 2, 4, 8, 0],
      [0, 6, 7, 4, 7, 0, 2, 8, 7, 5, 0],
      [0, 7, 6, 8, 7, 0, 4, 7, 4, 6, 0],
      [0, 6, 5, 7, 2, 0, 8, 4, 6, 5, 0]
    ]
  },
  {
    "level": 3,
    "matrix": [
      [5, 0, 5, 0, 5, 0, 5, 0, 5, 0, 5],
      [5, 0, 5, 0, 5, 0, 5, 0, 5, 0, 5],
      [5, 0, 5, 0, 5, 0, 5, 0, 5, 0, 5],
      [5, 0, 6, 5, 6, 5, 6, 5, 6, 0, 5],
      [5, 0, 5, 0, 5, 0, 5, 0, 5, 0, 5],
      [5, 0, 5, 0, 5, 0, 5, 0, 5, 0, 5],
      [5, 0, 5, 0, 5, 0, 5, 0, 5, 0, 5],
      [5, 0, 5, 0, 5, 0, 5, 0, 5, 0, 5],
      [5, 0, 5, 0, 5, 0, 5, 0, 5, 0, 5],
      [7, 0, 6, 0, 6, 0, 6, 0, 6, 0, 7],
      [5, 0, 5, 0, 5, 0, 5, 0, 5, 0, 5]
    ]
  }
]